province,城市,现存确诊,累计确诊,死亡,治愈
北京,东城区,1233,1241,0,8
北京,西城区,866,868,0,2
北京,朝阳区,5671,5673,0,2
北京,海淀区,2116,2118,0,2
北京,丰台区,1584,1587,0,3
北京,石景山区,874,875,0,1
北京,门头沟区,452,452,0,0
北京,房山区,579,579,0,0
北京,通州区,1842,1842,0,0
北京,顺义区,765,766,0,1
北京,昌平区,1374,1375,0,1
北京,大兴区,574,590,0,16
北京,怀柔区,305,305,0,0
北京,密云区,378,378,0,0
北京,延庆区,306,306,0,0
北京,平谷区,324,324,0,0
