province,城市,现存确诊,累计确诊,死亡,治愈
山西,太原,97,753,0,656
山西,大同,523,1354,0,831
山西,阳泉,39,526,0,487
山西,长治,22,120,0,98
山西,晋城,203,331,0,128
山西,朔州,3,502,0,499
山西,晋中,0,147,0,147
山西,忻州,9,145,0,136
山西,运城,21,308,0,287
山西,临汾,77,314,0,237
山西,吕梁,22,399,0,377
