province,城市,现存确诊,累计确诊,死亡,治愈
江苏,南京,58,861,0,803
江苏,无锡,58,208,0,150
江苏,徐州,22,182,0,160
江苏,常州,3,87,0,84
江苏,苏州,58,310,0,252
江苏,南通,44,85,0,41
江苏,连云港,58,403,0,345
江苏,淮安,25,108,0,83
江苏,盐城,58,184,0,126
江苏,扬州,2,596,0,594
江苏,镇江,17,41,0,24
江苏,泰州,26,73,0,47
江苏,宿迁,58,100,0,42
